*****
* H *
* * *
* * *
*   *
  *
 ***
  *
* F *
*****