*********
* H     *
* * *** *
* * *   *
*   * * *
  *     *
 *** ** *
  *     *
*   * * *
***F  F *
*** *** *
*** *** *
***     *